WWWWWWWWWWWWWWWWWWWWWWWWWWWW
WffffffffffffWWffffffffffPfW
WIWWWWfWWWWWfWWfWWWWWfWWWWfW
WuWWWWfWWWWWfWWfWWWWWfWWWWuW
WfWWWWfWWWWWfWWfWWWWWfWWWWfW
WffffffffffffffffffffffffffW
WfWWWWfWWfWWWWWWWWfWWfWWWWfW
WfWWWWfWWfWWWWWWWWfWWfWWWWfW
WffffffWWffffWWffffWWffffffW
WWWWWWfWWWWW-WW-WWWWWfWWWWWW
|||||WfWW----------WWfW|||||
WWWWWWfWW-WWW--WWW-WWfWWWWWW
--M---f---WW----WW---f------
WWWWWWfWW-WWWWWWWW-WWfWWWWWW
|||||WfWW----------WWfW|||||
WWWWWWfWW-WWWWWWWW-WWfWWWWWW
WffffffffffffWWffffffffffffW
WfWWWWfWWWWWfWWfWWWWWfWWWWfW
WfWWWWfWWWWWfWWfWWWWWfWWWWfW
WuffWWffffffffffffffffWWffuW
WWWfWWfWWfWWWWWWWWfWWfWWfWWW
WWWfWWfWWfWWWWWWWWfWWfWWfWWW
WffffffWWffffWWffffWWffffffW
WfWWWWWWWWWWfWWfWWWWWWWWWWfW
WfWWWWWWWWWWfWWfWWWWWWWWWWfW
WffBffffffffffffffffffffCffW
WWWWWWWWWWWWWWWWWWWWWWWWWWWW