WWWWWWW
W-----W
W-WWW-W
W--WW-W
WW-WW-W
W-BfM-W
WWWWWWW