WWWWWWW
WufffuW
WfWWWfW
WfPWWfW
WWfWWfW
WuffMuW
WWWWWWW