WWWWWWWWWWWWWWWWWWWWWWWWWWWW
WffffffffffffWWffffffffffffW
WfWWWWfWWWWWfWWfWWWWWfWWWWfW
WuWWWWfWWWWWfWWfWWWWWfWWWWuW
WfWWWWfWWWWWfWWfWWWWWfWWWWfW
WffffffffffffffffffffffffffW
WfWWWWfWWfWWWWWWWWfWWfWWWWfW
WfWWWWfWWfWWWWWWWWfWWfWWWWfW
WffffffWWffffWWffffWWffffffW
WWWWWWfWWWWW-WW-WWWWWfWWWWWW
|||||WfWW----------WWfW|||||
WWWWWWfWW-WWW--WWW-WWfWWWWWW
------f---WWIBCPWW---f------
WWWWWWfWW-WWWWWWWW-WWfWWWWWW
|||||WfWW----------WWfW|||||
WWWWWWfWW-WWWWWWWW-WWfWWWWWW
WffffffffffffWWffffffffffffW
WfWWWWfWWWWWfWWfWWWWWfWWWWfW
WMWWWWfWWWWWfWWfWWWWWfWWWWfW
WuffWWffffffffffffffffWWffuW
WWWfWWfWWfWWWWWWWWfWWfWWfWWW
WWWfWWfWWfWWWWWWWWfWWfWWfWWW
WffffffWWffffWWffffWWffffffW
WfWWWWWWWWWWfWWfWWWWWWWWWWfW
WfWWWWWWWWWWfWWfWWWWWWWWWWfW
WffffffffffffffffffffffffffW
WWWWWWWWWWWWWWWWWWWWWWWWWWWW